111111111111111111
1000C0000000000001
1001000000C0000C01
100000P11100000001
100000E00000C00001
100000000000000000
111111111111111111
101000000000000001
111111111111111111
