11111111111111111111111111111111111111111111111111111111
1P00C000000000000000000000000000000000000000000000000001
10000C00000000000000000000000000100000000000000000000001
10000C00000000000000000000000000100000000000000000000001
100000C0000000000000000000000000100000000000000000000001
1000000C000000000000000000000000000000000000000000000001
10000000C00000000000000000000000100000000000000000000001
100000000C0000000000000000000000100000000000000000000001
1000000000C000000000000000000000000000000000000000000001
10000000000C00000000000000000000100000000000000000000001
100000000000C0000000000000000000100000000000000000000001
1000000000000C000000000000000000100000000000000000000001
10000C0000000E000000000000000000100000000000000000000001
10000C00000000000000000000000000100000000000000000000001
10000C00000000000000000000000000100000000000000000000001
10000C00000000000000000000000000100000000000000000000001
10000C00000000000000000000000000100000000000000000000001
11111111111111111111111111111111111111111111111111111111
