111111111111111
1P010000000CC01
1000011111E0C01
100000000000101
1110C111C000001
1000010C1110001
111111111111111